Acadian Flycatcher: acafly
Acorn Woodpecker: acowoo
Alder Flycatcher: aldfly
American Avocet: ameavo
American Crow: amecro
American Goldfinch: amegfi
American Kestrel: amekes
American Pipit: amepip
American Redstart: amered
American Robin: amerob
American Wigeon: amewig
American Tree Sparrow: amtspa
Andean Solitaire: andsol1
Anna's Hummingbird: annhum
Ash-throated Flycatcher: astfly
Azara's Spinetail: azaspi1
Bay-breasted Warbler: babwar
Bald Eagle: baleag
Baltimore Oriole: balori
Bananaquit: banana
Bank Swallow: banswa
Banded Wren: banwre1
Barred Antshrike: barant1
Barn Swallow: barswa
Band-tailed Pigeon: batpig1
Blue-and-white Swallow: bawswa1
Black-and-white Warbler: bawwar
Bay Wren: baywre1
Black-bellied Whistling-Duck: bbwduc
Black-crowned Night-Heron: bcnher
Belted Kingfisher: belkin1
Bell's Vireo: belvir
Bewick's Wren: bewwre
Black-billed Magpie: bkbmag1
Black-bellied Plover: bkbplo
Blackburnian Warbler: bkbwar
Black-capped Chickadee: bkcchi
Black-headed Grosbeak: bkhgro
Yellow-throated Toucan: bkmtou1
Black-necked Stilt: bknsti
Blue-black Grassquit: blbgra1
Black-billed Thrush: blbthr1
Black-chested Jay: blcjay1
Black-capped Tanager: blctan1
Blue-headed Parrot: blhpar1
Black Phoebe: blkpho
Black-striped Sparrow: blsspa1
Blue Grosbeak: blugrb1
Blue Jay: blujay
Brown-crested Flycatcher: bncfly
Brown-headed Cowbird: bnhcow
Boat-billed Flycatcher: bobfly1
Bonaparte's Gull: bongul
Boat-tailed Grackle: botgra
Broad-billed Motmot: brbmot1
Brown-backed Solitaire: brbsol1
Brown-capped Vireo: brcvir1
Brewer's Blackbird: brebla
Brown Creeper: brncre
Brown Jay: brnjay
Brown Thrasher: brnthr
Bright-rumped Attila: brratt1
Broad-winged Hawk: brwhaw
Bronze-winged Parrot: brwpar1
Black-throated Blue Warbler: btbwar
Black-throated Green Warbler: btnwar
Black-throated Gray Warbler: btywar
Lesson's Motmot: bucmot2
Blue-gray Gnatcatcher: buggna
Blue-gray Tanager: bugtan
Blue-headed Vireo: buhvir
Bullock's Oriole: bulori
Buff-rumped Warbler: burwar1
Bushtit: bushti
Buff-throated Saltator: butsal1
Blue-winged Teal: buwtea
Cackling Goose: cacgoo1
Cactus Wren: cacwre
California Quail: calqua
California Towhee: caltow
Canada Goose: cangoo
Canada Warbler: canwar
Carolina Chickadee: carchi
Carolina Wren: carwre
Cassin's Finch: casfin
Cassin's Kingbird: caskin
Caspian Tern: caster1
Cassin's Vireo: casvir
Cattle Egret: categr
Chestnut-capped Brushfinch: ccbfin
Cedar Waxwing: cedwax
Chestnut-backed Antbird: chbant1
Chestnut-backed Chickadee: chbchi
Chestnut-breasted Wren: chbwre1
Chestnut-crowned Antpitta: chcant2
Chipping Sparrow: chispa
Chestnut-sided Warbler: chswar
Cinnamon Flycatcher: cinfly2
Clark's Nutcracker: clanut
Clay-colored Thrush: clcrob
Cliff Swallow: cliswa
Common Chlorospingus: cobtan1
Cocoa Woodcreeper: cocwoo1
Common Ground Dove: cogdov
Colombian Chachalaca: colcha1
Collared Trogon: coltro1
Common Goldeneye: comgol
Common Grackle: comgra
Common Loon: comloo
Common Merganser: commer
Common Pauraque: compau
Common Potoo: compot1
Common Raven: comrav
Common Yellowthroat: comyel
Cooper's Hawk: coohaw
Common Tody-Flycatcher: cotfly1
California Scrub-Jay: cowscj1
Crested Guan: cregua1
Crested Oropendola: creoro1
Crimson-fronted Parakeet: crfpar
Curve-billed Thrasher: cubthr
Dark-eyed Junco: daejun
Downy Woodpecker: dowwoo
Dusky-capped Flycatcher: ducfly
Dusky Flycatcher: dusfly
Eastern Bluebird: easblu
Eastern Kingbird: easkin
Eastern Meadowlark: easmea
Eastern Phoebe: easpho
Eastern Towhee: eastow
Eastern Wood-Pewee: eawpew
Elegant Trogon: eletro
Eurasian Collared-Dove: eucdov
European Starling: eursta
Ferruginous Pygmy-Owl: fepowl
Field Sparrow: fiespa
Flame-rumped Tanager: flrtan1
Fox Sparrow: foxspa
Gadwall: gadwal
Gambel's Quail: gamqua
Gartered Trogon: gartro1
Great Black-backed Gull: gbbgul
Gray-breasted Wood-Wren: gbwwre1
Golden-crowned Warbler: gcrwar
Gila Woodpecker: gilwoo
Green-tailed Towhee: gnttow
Green-winged Teal: gnwtea
Golden-crowned Flycatcher: gocfly1
Golden-crowned Kinglet: gockin
Golden-crowned Sparrow: gocspa
Golden-faced Tyrannulet: goftyr1
Golden-headed Quetzal: gohque1
Golden-olive Woodpecker: goowoo1
Grayish Saltator: grasal1
Groove-billed Ani: grbani
Great Blue Heron: grbher3
Great Crested Flycatcher: grcfly
Great Egret: greegr
Great Kiskadee: grekis
Greater Pewee: grepew
Great Thrush: grethr1
Great Tinamou: gretin1
Greater Yellowlegs: greyel
Gray-headed Chachalaca: grhcha1
Great Horned Owl: grhowl
Green Heron: grnher
Green Jay: grnjay
Great-tailed Grackle: grtgra
Gray Catbird: grycat
Gray Hawk: gryhaw2
Greater White-fronted Goose: gwfgoo
Hairy Woodpecker: haiwoo
Hepatic Tanager: heptan
Herring Gull: hergul
Hermit Thrush: herthr
Hermit Warbler: herwar
Andean Motmot: higmot1
Hoffmann's Woodpecker: hofwoo1
House Finch: houfin
House Sparrow: houspa
House Wren: houwre
Hutton's Vireo: hutvir
Inca Dove: incdov
Indigo Bunting: indbun
Keel-billed Toucan: kebtou1
Killdeer: killde
Ladder-backed Woodpecker: labwoo
Lark Sparrow: larspa
Laughing Falcon: laufal1
Laughing Gull: laugul
Lazuli Bunting: lazbun
Least Flycatcher: leafly
Least Sandpiper: leasan
Lesser Goldfinch: lesgol
Lesser Greenlet: lesgre1
Lesser Violetear: lesvio1
Lincoln's Sparrow: linspa
Lineated Woodpecker: linwoo1
Little Tinamou: littin1
Long-billed Dowitcher: lobdow
Long-billed Gnatwren: lobgna5
Loggerhead Shrike: logshr
Long-tailed Duck: lotduc
Long-tailed Manakin: lotman1
Lucy's Warbler: lucwar
MacGillivray's Warbler: macwar
Magnolia Warbler: magwar
Mallard: mallar3
Marsh Wren: marwre
Masked Trogon: mastro1
Mealy Parrot: meapar
Melodious Blackbird: melbla1
Montezuma Oropendola: monoro1
Mountain Chickadee: mouchi
Mourning Dove: moudov
Mountain Elaenia: mouela1
Mountain Quail: mouqua
Mourning Warbler: mouwar
Mute Swan: mutswa
Nashville Warbler: naswar
Northern Cardinal: norcar
Northern Flicker: norfli
Northern Mockingbird: normoc
Northern Parula: norpar
Northern Shoveler: norsho
Northern Waterthrush: norwat
Northern Rough-winged Swallow: nrwswa
Nuttall's Woodpecker: nutwoo
Oak Titmouse: oaktit
Orange-billed Nightingale-Thrush: obnthr1
Ochre-bellied Flycatcher: ocbfly1
Olivaceous Woodcreeper: oliwoo1
Olive-sided Flycatcher: olsfly
Orange-bellied Euphonia: orbeup1
Orange-billed Sparrow: orbspa1
Orange-chinned Parakeet: orcpar
Orange-crowned Warbler: orcwar
Orange-fronted Parakeet: orfpar
Osprey: osprey
Ovenbird: ovenbi1
Pale-breasted Spinetail: pabspi1
Palm Tanager: paltan1
Palm Warbler: palwar
Pacific-slope Flycatcher: pasfly
Pale-vented Pigeon: pavpig2
Philadelphia Vireo: phivir
Pied-billed Grebe: pibgre
Pileated Woodpecker: pilwoo
Pine Siskin: pinsis
Piratic Flycatcher: pirfly1
Cabanis's Wren: plawre1
Plain Xenops: plaxen1
Plumbeous Vireo: plsvir
Plumbeous Pigeon: plupig2
Prothonotary Warbler: prowar
Purple Finch: purfin
Purple Gallinule: purgal2
Purple-throated Fruitcrow: putfru1
Pygmy Nuthatch: pygnut
Rufous-and-white Wren: rawwre1
Red-crowned Ant-Tanager: rcatan1
Red-breasted Nuthatch: rebnut
Red-breasted Sapsucker: rebsap
Red-bellied Woodpecker: rebwoo
Red Crossbill: redcro
Red-eyed Vireo: reevir1
Red-headed Barbet: rehbar1
Red-lored Parrot: relpar
Red-shouldered Hawk: reshaw
Red-tailed Hawk: rethaw
Red-winged Blackbird: rewbla
Ring-billed Gull: ribgul
Ringed Kingfisher: rinkin1
Roadside Hawk: roahaw
Rose-breasted Grosbeak: robgro
Rock Pigeon: rocpig
Rose-throated Becard: rotbec
Royal Tern: royter1
Ruby-throated Hummingbird: rthhum
Rufous-tailed Hummingbird: rtlhum
Russet-backed Oropendola: ruboro1
Rufous-browed Peppershrike: rubpep1
Rufous-backed Robin: rubrob
Rufous-breasted Wren: rubwre1
Ruby-crowned Kinglet: ruckin
Rufous-collared Sparrow: rucspa1
Rufous-capped Warbler: rucwar
Russet-crowned Warbler: rucwar1
Ruddy Pigeon: rudpig
Ruddy Turnstone: rudtur
Rufous Hummingbird: rufhum
Ruddy Ground Dove: rugdov
Rusty-margined Flycatcher: rumfly1
Rufous-naped Wren: runwre1
Rufous-tailed Jacamar: rutjac1
Saffron Finch: saffin
Sandhill Crane: sancra
Sanderling: sander
Savannah Sparrow: savspa
Say's Phoebe: saypho
Scarlet Macaw: scamac1
Scarlet Tanager: scatan
Scaly-breasted Wren: scbwre1
Scale-crested Pygmy-Tyrant: scptyr1
Scrub Tanager: scrtan1
Semipalmated Plover: semplo
Shiny Cowbird: shicow
Silver-beaked Tanager: sibtan2
Sinaloa Wren: sinwre1
Slate-throated Redstart: sltred
Smooth-billed Ani: smbani
Snow Goose: snogoo
Southern Beardless-Tyrannulet: sobtyr1
Social Flycatcher: socfly1
Solitary Sandpiper: solsan
Song Sparrow: sonspa
Southern Lapwing: soulap1
Spotted Sandpiper: sposan
Spotted Towhee: spotow
Sparkling Violetear: spvear1
Squirrel Cuckoo: squcuc1
Streak-backed Oriole: stbori
Steller's Jay: stejay
Streak-headed Antbird: sthant1
Streak-headed Woodcreeper: sthwoo1
Striped Cuckoo: strcuc1
Streaked Flycatcher: strfly1
Streaked Saltator: strsal1
Steely-vented Hummingbird: stvhum2
Sulphur-bellied Flycatcher: subfly
Summer Tanager: sumtan
Swamp Sparrow: swaspa
Swainson's Thrush: swathr
Tennessee Warbler: tenwar
Thick-billed Euphonia: thbeup1
Thick-billed Kingbird: thbkin
Three-striped Warbler: thswar1
Townsend's Solitaire: towsol
Tree Swallow: treswa
Tropical Gnatcatcher: trogna1
Tropical Kingbird: trokin
Tropical Mockingbird: tromoc
Tropical Parula: tropar
Tropical Pewee: tropew1
Tufted Titmouse: tuftit
Tundra Swan: tunswa
Veery: veery
Verdin: verdin
Violet-green Swallow: vigswa
Warbling Vireo: warvir
White-breasted Wood-Wren: wbwwre1
Wedge-billed Woodcreeper: webwoo1
White-eared Ground-Sparrow: wegspa1
Black-crowned Antshrike: wesant1
Western Bluebird: wesblu
Western Kingbird: weskin
Western Meadowlark: wesmea
Western Tanager: westan
Western Wood-Pewee: wewpew
White-bearded Manakin: whbman1
White-breasted Nuthatch: whbnut
White-crowned Parrot: whcpar
Morelet's Seedeater: whcsee1
White-crowned Sparrow: whcspa
White-eyed Vireo: whevir
White-fronted Parrot: whfpar1
Whimbrel: whimbr
Whiskered Wren: whiwre1
White-tipped Dove: whtdov
White-throated Sparrow: whtspa
White-winged Becard: whwbec1
White-winged Dove: whwdov
Willow Flycatcher: wilfly
Willet: willet1
Wilson's Snipe: wilsni1
Wild Turkey: wiltur
Wilson's Warbler: wlswar
Wood Duck: wooduc
Wood Thrush: woothr
Wrentit: wrenti
American Coot: y00475
Yellow-breasted Chat: yebcha
Yellow-bellied Elaenia: yebela1
Yellow-bellied Flycatcher: yebfly
Yellow-backed Oriole: yebori1
Yellow-bellied Sapsucker: yebsap
Yellow-bellied Seedeater: yebsee1
Yellow-faced Grassquit: yefgra1
Yellow-green Vireo: yegvir
Yellow-headed Blackbird: yehbla
Yellow-headed Caracara: yehcar1
Yellow Grosbeak: yelgro
Yellow Warbler: yelwar
Yellow-olive Flycatcher: yeofly1
Yellow-rumped Warbler: yerwar
Yellow-throated Euphonia: yeteup1
Yellow-throated Vireo: yetvir
